111111111111111111111111111111111
1C0000000000000100000100000000001
111111100101010000000000001010C01
100001010101001111111111001011111
101100010101001000000000001010011
1011110101010010E0101101011010001
10100100C100001111101101001000101
1010000001000000C00000010100C0101
101011101111011111111101001011001
1P100C000000000C000001000000001N1
111111111111111111111111111111111
