111111111111111111111111111111111111111111
100000000000000000000000000000000000000001
100000000000000000000000000000000000000001
1000000000000000000000000000N0000000000001
100000000000000000000000000000000000000001
1000000000000CCCCCCC0000000000000000000001
100000000000000000000000000000000000000001
100000000000000000000000000000000000000001
1000P0000000000000000000000000000000000001
1000000000000000000000000000000000000000E1
111111111111111111111111111111111111111111