1111111111111
1000001000001
10110000N0101
1P10C000001E1
1111111111111