1111111111111
1P00001000001
10110000N0101
1010C000001E1
1111111111111