1111111111111
10E100000N001
10C0011111001
10P0110001001
1111111111111
