1111111111111
1001001000001
10C00000001N1
10P01100001E1
1111111111111