111111
1000E1
1P00C1
1N00C1
111111